100090000009000000000000000000000
000090009999000000000000000000000
000090009999000000000000000000000
900090009999000000000000000000000
600000000000000000000000000000002